filename, language, Python, Shell Script, Markdown, comment, blank, total
/Users/mhlwsk/实验二+1173710132+1173710217/属性词情感词抽取/ERNIE/ERNIE_etract/config.py, Python, 16, 0, 0, 13, 3, 32
/Users/mhlwsk/实验二+1173710132+1173710217/属性词情感词抽取/ERNIE/ERNIE_etract/dataset.py, Python, 55, 0, 0, 36, 18, 109
/Users/mhlwsk/实验二+1173710132+1173710217/属性词情感词抽取/ERNIE/ERNIE_etract/gen_feature_sents.py, Python, 64, 0, 0, 17, 9, 90
/Users/mhlwsk/实验二+1173710132+1173710217/属性词情感词抽取/ERNIE/ERNIE_etract/predict.py, Python, 79, 0, 0, 42, 18, 139
/Users/mhlwsk/实验二+1173710132+1173710217/属性词情感词抽取/ERNIE/ERNIE_etract/run_predict.sh, Shell Script, 0, 4, 0, 0, 2, 6
/Users/mhlwsk/实验二+1173710132+1173710217/属性词情感词抽取/ERNIE/ERNIE_etract/run_sequence_label.sh, Shell Script, 0, 12, 0, 0, 2, 14
/Users/mhlwsk/实验二+1173710132+1173710217/属性词情感词抽取/ERNIE/ERNIE_etract/sequence_label.py, Python, 53, 0, 0, 30, 12, 95
/Users/mhlwsk/实验二+1173710132+1173710217/属性词情感词抽取/ERNIE/ERNIE_mapping/README.md, Markdown, 0, 0, 1, 0, 2, 3
/Users/mhlwsk/实验二+1173710132+1173710217/属性词情感词抽取/ERNIE/ERNIE_mapping/config.py, Python, 20, 0, 0, 14, 4, 38
/Users/mhlwsk/实验二+1173710132+1173710217/属性词情感词抽取/ERNIE/ERNIE_mapping/dataset.py, Python, 42, 0, 0, 2, 14, 58
/Users/mhlwsk/实验二+1173710132+1173710217/属性词情感词抽取/ERNIE/ERNIE_mapping/gen_train_data.py, Python, 70, 0, 0, 17, 13, 100
/Users/mhlwsk/实验二+1173710132+1173710217/属性词情感词抽取/ERNIE/ERNIE_mapping/predict.py, Python, 213, 0, 0, 44, 22, 279
/Users/mhlwsk/实验二+1173710132+1173710217/属性词情感词抽取/ERNIE/ERNIE_mapping/run_classifier.sh, Shell Script, 0, 15, 0, 36, 5, 56
/Users/mhlwsk/实验二+1173710132+1173710217/属性词情感词抽取/ERNIE/ERNIE_mapping/run_predict.sh, Shell Script, 0, 9, 0, 9, 3, 21
/Users/mhlwsk/实验二+1173710132+1173710217/属性词情感词抽取/ERNIE/ERNIE_mapping/text_classifier.py, Python, 89, 0, 0, 35, 12, 136
/Users/mhlwsk/实验二+1173710132+1173710217/属性词情感词抽取/ERNIE/ERNIE_mapping/wash_data.py, Python, 158, 0, 0, 16, 20, 194
Total, -, 859, 40, 1, 311, 159, 1370