filename, language, Python, Markdown, Shell Script, comment, blank, total
/Users/mhlwsk/实验二+1173710132+1173710217/属性分类/ERNIE/README.md, Markdown, 0, 1, 0, 0, 2, 3
/Users/mhlwsk/实验二+1173710132+1173710217/属性分类/ERNIE/config.py, Python, 36, 0, 0, 15, 6, 57
/Users/mhlwsk/实验二+1173710132+1173710217/属性分类/ERNIE/dataset.py, Python, 42, 0, 0, 2, 14, 58
/Users/mhlwsk/实验二+1173710132+1173710217/属性分类/ERNIE/gen_train_data.py, Python, 29, 0, 0, 0, 5, 34
/Users/mhlwsk/实验二+1173710132+1173710217/属性分类/ERNIE/predict.py, Python, 111, 0, 0, 31, 15, 157
/Users/mhlwsk/实验二+1173710132+1173710217/属性分类/ERNIE/run_classifier.sh, Shell Script, 0, 0, 15, 36, 5, 56
/Users/mhlwsk/实验二+1173710132+1173710217/属性分类/ERNIE/run_predict.sh, Shell Script, 0, 0, 9, 9, 3, 21
/Users/mhlwsk/实验二+1173710132+1173710217/属性分类/ERNIE/text_classifier.py, Python, 91, 0, 0, 35, 12, 138
/Users/mhlwsk/实验二+1173710132+1173710217/属性分类/ERNIE/wash_data.py, Python, 158, 0, 0, 16, 20, 194
Total, -, 467, 1, 24, 144, 82, 718